
 a l l l l a l
 l l b b l l b
 l c l l c l c
 l l lal l l a
 l c l l c l c
 l l l l l l l
 a l l l l a l
 l l     l l l
     b b     
a ll     ll a
     l l
 l l lll l l l
 l l c c l l l
 a l l l l a l
 l l     l l l
 l l lll l l l
     lAl