
 l a l l a l l
 l l c c l l c
 b l l l l b l
 l l lal l l a
 l l l l b l b
 l c l l b l c
 l c l l l l c
 l l     l l l
     b b    
a ll     ll a
     l l
 c l lcl l c l
 l l l l l l l
 a l a l a l a
 l l     l l l
 l l lll l l l
     lAl